~~~~~~~~~~~~~~~~~~~~
~~~~~~~~~~~~~~~~~~~~
~~OOOOOOOOOOOOOOOO~~
~~O              O~~
~~O              O~~
~~O              O~~
~~O              O~~
~~O              O~~
~~O              O~~
~~OOOOOOOOOOOOOOOO~~
~~~~~~~~~~~~~~~~~~~~
~~~~~~~~~~~~~~~~~~~~